introspection - examining one's own thoughts and feelings
philanthropist - one who loves mankind
antidote - medicine used against a poison or a disease
strive - to make great efforts, to struggle
ambidextrous - able to use the left hand or the right equally well
precursors - a person or thing that precedes, as in a  process or job.
retrospective - Looking back on past
introvert - one who turns towards himself
ambiguous - doubtful; uncertain
gerontocracy - government ruled by old people
aggravate - make worse; irritate
braggart - boastful
entice - attract, lure
equilibrium - state of being balanced 
alleviate - make (pain) easier to bear
adorn - add beauty; decorate
malevolent - malicious; evil; having or showing ill will
connote - Suggest or imply in addition to the precise, literal meaning
abhor - to hate; to detest
agile - active; quick-moving
endeavor - to make an effort, to try very hard
stray - wander lose one's way
renovate - restore something to better condition 
curriculum - course of study 
amalgamate - mix; combine; unite societies
drowsiness - feeling sleepy half asleep 
disrobe - undress
xenophile (zen-uh-fahyl) - a person who is attracted to foreign peoples cultures
suffocate - cause or have difficulty in breathing 
sequence - succession connected line of 
scent - smell (especially pleasant) 
sporadic - happening from time to time
affinity - close connection; relationship
audacious - Bold
heterogeneous - made up of different kinds 
animosity - strong dislike
fragile - easily injured broken or destroyed 
acumen - Keen, quick, accurate insight or judgment
legacy - Bequest or inheritance
massacre - cruel killing of a large number of people 
submerge - put under water liquid sink out of sight 
combustion - process of burning 
adulteration - making unpure; poorer in quality
appease - make quiet or calm
premature - doing or happening something before the right time 
inquest - Legal or judicial inquiry, especially before a jury and especially made by a coroner into the cause of someone.s death
shunned - avoided, kept away from
conceal - hide keep secret 
anguish - severe suffering
indigenous - native
apt - well-suited; quick-witted
correlate - have a mutual relation 
grumble - to complain
offhand - Without preparation or forethought
somersault - rolling backward or forward (not sideways) movement
extinguish - end the existence of/wipe or put out 
edible - fit to be eaten/not poisonous 
conjoin - to join together 
surcharge - additional load/charge 
accolade - praise; approval
disallow - refuse to allow or accept as a correct 
opaqueness - dullness/not allowing light to pass through 
impermeable - that cannot be permeated 
console - give comfort or sympathy to 
timid - shy easily frightened 
abscond - to go away suddenly (to avoid arrest)
abide - be faithful; to endure
embezzle - use in a wrong way for one's own benefit
warrant - authority written order guarantee 
reminiscent - suggest something in the past
extinct - no longer active 
loll - rest to sit or stand in a lazy way hang (dog's tongue)
acclaimed - welcomed with shouts and approval
clientele - customers 
catalyst - substance that causes speeding up 
shallow - little depth; not earnest 
brittle - easily broken 
negligent - taking too little care 
affable - polite and friendly
poseur - a person who attempts to impress by acting unlike himself
dangle - hand or swing loosely
moribund - in a dying state; near death
ascend - go or come up 
relapse - fall back again 
asterisk - the mark * (e.g.. omitted letters) 
yarn - tale story fibers for knitting 
arrogance - proud; superior manner of behaviour 
salvage - the saving of property from loss
livid - Furiously angry, enraged
divergence - getting farther apart from a point 
rejuvenation - becoming young in nature or appearance 
allegiance - duty support loyalty
vigorous - strong energetic 
dullard - a stupid, insensitive person
dwarf - person much smaller the usual size 
fragrant - sweet-smelling 
judicious - sound in judgment; wise 
nihilism - total rejection of all religious and moral beliefs
odor - smell
scribble - write hastily 
hospitable - liking to give hospitality 
narcissism - Self-love
sawdust - tiny bits of wood 
ameliorate - improve; make better
ingest - take in by swallowing 
gait - a manner of walking, stepping, or running
sluggard - lazy slow-moving person 
succumb - yield, die
reiterate - say or do again several times 
flop - fail/move/fall clumsily 
defer - postpone
ossified - turned to bone; hardened like bone; Inflexible
eloquence - fluent speaking skillful use of language 
derivative - unoriginal; obtained from another source 
commuter - person who travels regularly 
clot - half-solid lump formed from liquid 
weigh - measure hoe heavy something is 
steeply - rising or falling sharply 
torque - twisting force causing rotation 
benefactor - person who has given help 
complaisant - trying to please; obliging
plea - request 
moderation - quality of being limited; not extreme 
enduring - lasting 
invincible - too strong to be defeated 
sanity - health of mind soundness of judgment 
turmoil - trouble disturbance 
flimsy - lacking solidarity, strength
tadpole - form of a frog when it leaves the egg 
reconcile - settle a quarrel restore peace 
cryptic - secret with a hidden meaning 
sponge - porous rubber for washing live at once expense 
commemorate - keep the memory of 
sadistic - Cruel
dote - show much fondness center one's attention
encapsulate - enclose in capsule 
fission - splitting or division (esp. of cells) 
volatile - changeable inconstant fickle unstable explosive 
alloy - to debase by mixing with something inferior
dormant - in a state of inactivity but awaiting development 
gallant - brave,behaves well with women
grievous - causing grief or pain; serious dire grave 
enzyme - catalyst 
shard - A piece of broken pottery
hypocrisy - falsely making oneself appear to be good 
eradicate - get rid of pull up by the roots 
chisel - steel tool for shaping materials 
infuriate - fill with fury or rage 
engulf - swallow up 
euphoria - elation state of pleasant excitement 
sanction - approval (by authority) penalty 
renowned - celebrated; famous 
riddle - puzzling person or thing 
evoke - call up bring out 
mischievous - harmful; causing mischief 
implicit - implied though; not plainly expressed
disproof - proof to the contrary 
misogynist - one who hates women/females 
abysmal - extreme bad
writ - written order 
pertain - belong as a part have reference 
erratic - irregular in behaviour or opinion 
meticulous - giving great attention to details 
impromptu - without preparation 
inclined - directing the mind in a certain direction 
constrict - make tight or smaller 
perish - be destroyed decay 
Lambaste - attack verbally
luminary - star; light-giving body 
dupe - cheat make a fool of 
auxiliary - helping; supporting 
extralegal - outside the law 
ambivalent - having both of two contrary meanings
tonic - something giving strength or energy 
endorse - write one's name on the back of
turbulence - being uncontrollably violent 
connoisseur - a person with good judgement (e.g.. in art) 
indistinct - not easily heard; seen clearly marked 
abstruse - difficult to comprehend; obscure
limp - lacking strength; walking unevenly 
parenthesis - sentence within another one something separated 
sophisticated - complex; subtle; refined 
aberration - straying away from what is normal
recuperate - become strong after illness loss exhaustion 
perjury - willful FALSE statement unlawful act 
mite - A very small amount, portion, or particle
pest - destructive thing or a person who is nuisance 
pluck - pull the feathers off pick (e.g.. flowers) 
satiate - satisfy fully 
colloquial - involving or using conversation.
yeoman - man owning small estate; middle-class farmer
ail - to cause pain, uneasiness, or trouble to.
fidelity - loyalty accuracy 
mesmerize - hypnotize 
paradigm - a model example or pattern 
gullible - easily gulled 
sobriety - quality or condition of being sober 
dislodge - move force from the place occupied 
fleet - number of ships; quick-moving 
articulate - speak distinctly; connect by joints 
tractable - easily controlled or guided 
partisan - one-sided committed to a party biased or prejudiced 
predominate - have more power than others 
foolproof - incapable of failure or error 
suffice - be enough 
permeate - spread into every part of 
spear - weapon with a metal point on a long shaft 
solvent - of the power of forming a solution 
presentiment - anticipatory fear; premonition
vivacious - lively high-spirited 
coagulation - change to a thick and solid state 
liberality - free giving; generosity 
elaborate - worked out with much care in great detail 
brass - yellow metal (mixing copper and zinc) 
malleable - yielding easily shaped; moldable; adapting 
patron - regular customer person who gives support 
immutable - that cannot be changed 
forgery - counterfeit 
woo - try to win 
cordial - warm and sincere 
cumbersome - burdensome; heavy and awkward to carry 
beguile - mislead or delude; cheat; pass time
retrograde - receding 
sheath - cover for the blade of a weapon or a tool 
bewilder - puzzle; confuse 
knit - draw together; unite firmly 
unscathed - unharmed unhurt 
chortle - loud chuckle of pleasure or amusement
jabber - talk excitedly; utter rapidly 
pivotal - of great importance (others depend on it) 
implosion - collapse; bursting inward 
repel - refuse to accept/cause dislike 
superimpose - put something on the top 
centurion - leader of a unit of 100 soldiers 
enigma - something that is puzzling 
calipers - metal supports attached to the legs measuring instrument 
redeem - get back by payment compensate 
buoyant - able to float; light-hearted 
impede - hinder; get in the way of 
stride - walk with long steps 
boisterous - noisy; restraint 
resuscitation - coming back to consciousness 
concur - agree in opinion happen together 
recitals - a number of performance of music 
treacherous - not to be trusted, perfidious
indulgent - inclined to indulge 
pilferer - to steal, especially in small quantities
foster - nurture; care for 
apartheid - brutal racial discrimination
garrulous - too talkative
edify - instruct; correct morally
evasive - tending to evade 
misanthrope - person who hates mankind 
eulogy - formal praise panegyric 
arcane - known or understood by very few
bogus - sham; counterfeit; not genuine 
dexterity - skill (esp. in handling) 
lampoon - publicly mock or ridicule
skit - short piece of humorous writing 
incongruous - out of place; not in harmony or agreement 
repulsive - causing a feeling of disgust 
refine - make or become pure cultural 



abate - v. to diminish in intensity
aberrant - adj. diverging from the standard type
abjure - v. to reject or renounce
abscond - v. to leave secretly, evading detection
abstain - v. to voluntarily refrain from doing something
acumen - n. keen judgment and perception
admonish - v. scold or to advise firmly
adulterate - v. to contaminate or make impure by introducing inferior elements
advocate - v. to recommend, support, or advise
aesthetic - adj. concerned with the nature of beauty and art
affectation - n. fake or artificial behavior, often meant to impress or conceal the truth
aggrandize - v. enlarge or increase, esp. wealth, power, reputation
alacrity - n. promptness and eagerness
alleviate - v. to relieve a problem or ease a burden
amalgamate - v. to combine to or mix together
ambiguous - adj. unclear
ambivalent - adj. having mixed or contradictory feelings about someone or something
ameliorate - v. to improve or mitigate a situation
amenable - adj. easily convinced or persuaded
anachronism - n. something old-fashioned
analogous - n. comparable
anoint - v. to choose for a particular office or position
anomaly - n. an exception or unusual case
antipathy - n. strong dislike or hatred
antithetical - adj. contrary to the very nature of
apathy - n. state of total disinterest or unenthusiasm
appease - v. to placate
arbitrary - adj. seemingly chosen or designated without reason or purpose
arcane - adj. secret or known only to a select group
archaic - adj. old-fashioned
arduous - adj. difficult, taxing, requiring considerable effort
articulate - adj. exhibiting considerable communication skills, well-spoken
artless - adj. without artifice
ascetic - adj. austere or self-denying
assuage - v. to provide relief from an unpleasant feeling
astonishment - n. total surprise, shock
audacious - adj. very bold or presumptuous
austere - adj. severe, unadorned
avarice - n. greed
aver - v. to assert or allege
banal - adj. boring, clich√©
belie - v. give a false impression (intentional or unintentional) in word, appearance, or deed
benign - adj. gentle, harmless
biased - adj. prejudiced, displaying partiality
bolster - v. to shore up or support
bombastic - adj. overblown, theatrical
brazen - adj. bold or open to the point of shocking
bucolic - adj. pastoral, rustic, countryfied
burgeon - v. flourish, bloom, expand or increase quickly
cacophony - n. loud and chaotic noise
calumny - n. lie or slander
candid - adj. honest, open
canon - n. accepted rules and tenets of a discipline
capacity - n. the capability to perform a particular action or fulfill a given function
capricious - adj. mercurial, unpredictable, whimsical
castigate - v. to scold or berate strongly
catalyst - n. something that speeds up a process or causes action
caustic - adj. corrosive
censure - v. to express intense condemnation
chauvinist - n. someone who believes prejudicially that their own group is the superior one
chicanery - n. trickery or deception
chronological - adj. ordered by time
coalesce - v. to come together, esp. from disparate parts
cogent - adj. clearly laid out and persuasive
commensurate - adj. in accordance with, proportional
compelling - adj. captivating
comprehensive - adj. complete and thorough
condone - v. to approve or allow
confound - v. to confuse or astonish
connoisseur - n. an expert in a particular subject matter area, usually relating to the fine arts or cultural pursuits
consequential - adj. as a result of
construe - v. to interpret
consumption - n. utilization (esp. of a resource)
contend - v. assert or claim
contentious - adj. controversial
contrite - adj. remorseful
convoluted - adj. roundabout, not straightforward
copious - adj. plentiful or abundant
cosmopolitan - adj. of or relating to a city or urban area
covet - v. to desire something that does not belong to you
craft - n. cunning
craven - adj. cowardly to the point of being shameful
credence - n. belief or trust
credulous - adj. gullible, na√Øve
decorum - n. appropriate behavior or good manners
deference - n. respect or polite submission
deflect - v. divert or cause to ricochet
deftness - adj. skill, acumen
delineate - v. to describe very accurately
demur - v. to object or raise concerns
denigrate - v. say negative things about, particularly in a defamatory way
deride - v. to mock or ridicule
derivative - adj. imitates another work in a way that is unoriginal or uninspiring
desiccate - v. to dry out completely
desultory - adj. halfhearted
detachment - n. objectivity or aloofness
determinant - n. a strong factor in an outcome
diatribe - n. a rant or angry speech denouncing someone or something
didactic - adj. educational or with an instructive purpose; often includes an element of moralizing
diffident - adj. shy, timid, or reserved due to a lack of confidence
dilettante - n. someone with an amateur, nonserious interest in something
dirge - n. funeral or mourning lament
disabuse - v. to dispel someoneís illusions or false impressions about something
discern - v. to perceive
discrepancy - n. inconsistency
disinterested - adj. objective, unbiased
disparage - v. to belittle
disparate - adj. dissimilar to such a degree that comparison is not possible
dispassionate - adj. impartial or cool
disregard - v. to ignore or pay no attention to
dissemble - v. to mislead or conceal the truth, esp. with respect to oneís motives
disseminate - v. to spread widely (esp. information)
dissonance - n. a clash between two elements that donít blend well
diverge - v. to split apart, esp. a road or path
dogma - n. the official beliefs or tenets of particular sect or group
dupe - v. to deceive or fool
ebullient - adj. cheerful, enthusiastic, excited
eccentric - adj. quirky or unusual
eclectic - adj. composed of a variety of styles, themes, motifs, etc.
efficacy - n. effectiveness
elegy - n. sad poem or song, often in remembrance of someone deceased
elicit - v. to provoke a response
eloquence - adj. persuasive and articulate speech
eminent - adj. well-known, respected, distinguished
empirical - adj. based on evidence
emulate - v. to imitate or attempt to equal in accomplishment
enervate - v. to exhaust or drain of energy
engender - v. to cause or give rise to
enhance - v. intensify, increase, augment
entitlement - n. belief that one deserves things one has not earned
ephemeral - adj. short-lived or transient
equable - adj. even-tempered
equivocate - v. to use ambiguous language in order to mislead or deceive
erroneous - adj. incorrect
erudite - adj. learned
eschew - v. avoid or abstain from
esoteric - adj. obscure, arcane
estimable - adj. deserving respect, esteem, and admiration
eulogy - n. memorial speech for one who has passed, normally given at a funeral
exacerbate - v. to make worse
exacting - adj. challenging, demanding, grueling
exculpate - v. to exonerate or vindicate
exigent - adj. urgent or pressing
exonerate - v. to clear of charges of wrongdoing
expatiate - v. to elaborate on something in great detail
explicate - v. to explain in detail
exposition - n. a thorough explanation
extraneous - adj. irrelevant or superfluous
extrapolate - v. to estimate or conjecture about the future based on presently available information or facts
facetious - adj. glib or flippant
facilitate - v. to make something easier or simpler
fallacious - adj. relying on a fallacy and thus incorrect/misinformed
fastidious - adj. meticulous
fluctuate - v. to shift without apparent pattern
foment - v. to foster unrest or discontent
forestall - v. to hold off or try to prevent
fortuitous - adj. fortunate and lucky
frugal - adj. economical, thrifty
gainsay - v. deny or oppose
galvanize - v. to prod someone into action
garrulous - adj. talkative
gauche - adj. socially inept, inappropriate, or awkward
germane - adj. relevant to the matter at hand
glib - adj. talking volubly, but carelessly or insincerely
gregarious - adj. sociable, genial
guile - n. craftiness and cunning
hackneyed - adj. clich√©, trite, banal
harangue - n. diatribe or rant
hedonism - n. the pursuit of pleasure
hierarchical - adj. arranged in rank order or hierarchy
homogenous - adj. uniform, identical
hyperbole - n. obvious exaggeration for effect
iconoclast - n. a person who attacks traditional religious and cultural institutions
ideological - adj. relating to a particular belief system or theory
imminent - adj. about to happen
immutable - adj. unchangeable
impair - v. to hinder or weaken someone or something
impediment - n. barrier, hindrance, or obstruction
imperturbable - adj. remaining calm under any circumstance
implacable - adj. unforgiving
implicit - adj. implied or insinuated without being directly stated
imprudence - n. bad judgment
impudent - adj. disrespectful
inadvertent - adj. by accident or unintentional
Inchoate - adj. rudimentary, in the beginning stages
inconclusive - adj. indeterminate or unresolved
indebted - adj. owing money
indefatigable - adj. cannot be made tired
indolent - adj. lazy
infer - v. to conclude from implicit evidence (as opposed to explicit facts)
ingenuous - adj. na√Øve or innocent
inimical - adj. harmful or hostile
Innocuous - adj. harmless
inscrutable - adj. enigmatic, incomprehensible
insipid - adj. bland, uninspired, inane
insular - adj. tight-knit and isolated; uninterested in matters outside oneís immediate sphere
intensive - adj. concentrated and in-depth
intermediary - n. a go-between
intimate - adj. close (as in a relationship)
intractable - adj. unmanageable
intransigent - adj. uncompromising, obstinate
intrepid - adj. bold and adventurous
inveterate - adj. ingrained, habitual
invulnerable - adj. indestructible, impervious to harm
irascible - adj. irritable, testy, touchy
irresolute - adj. wishy-washy, hesitant
laconic - adj. taciturn, reserved, succinct
laud - v. to praise
laudable - adj. praiseworthy
litigation - n. legal proceedings
loquacious - adj. talkative
lucid - adj. clear and coherent
luminous - adj. full of light
magnanimity - n. generosity and nobility of spirit
maladroit - adj. clumsy, awkward, inept
malign - adj. evil or harmful
malleable - adj. pliant or pliable
maverick - n. an unorthodox person or rebel
mendacity - n. untruthfulness, dishonesty
mercurial - adj. easily changeable, fickle
meticulous - adj. paying close attention to detail
misanthrope - n. person who hates humanity
mitigate - v. to ¬†improve a painful, unpleasant, or negative situation
modest - adj. not boastful
mollify - v. placate
monotony - n. boredom and repetition
mundane - adj. everyday, boring
munificent - adj. very generous
na√Øve - adj. inexperienced or gullible
nascent - adj. just beginning or in the early stages
neglect - v. to abandon or leave uncared-for
nonplussed - adj. confused and baffled
notoriety - n. fame for doing something negative or criminal
nuance - n. subtle shades of difference
obdurate - adj. stubborn, obstinate
obscure - adj. mysterious or not well-known
obsequious - adj. overly fawning and helpful in a way that is disingenuous
obstinate - adj. stubborn, uncompromising
obviate - v. to forestall the need for something
occlude - v. to block or obstruct
occult - n. the mystical and supernatural
offset - v. to counterbalance or counteract
olfactory - adj. relating to smell or the sense of smell
omniscience - n. the quality or state of being all-knowing
onerous - adj. difficult or burdensome
opaque - adj. not see-through; blocking light
opportunism - n. the practice of taking advantage of opportunities as they arise without particular concern for morality or ethics
opprobrium - n. criticism or condemnation
oscillate - v. to swing back and forth between two points, poles, or positions
ostentatious - adj. overly showy in a way that is gaudy or vulgar
outstrip - v. to overtake or outrun
overshadow - v. to literally cast a shadow over
painstaking - adj. attentive to detail, meticulous
partial - adj. incomplete
partisan - n. a devoted supporter of a group, cause, or person
patent - adj. blatant, obvious
paucity - n. scarcity, poverty
pedantic - adj. overly concerned with irrelevant detail, fussy
pedestrian - adj. boring, monotonous, run-of-the-mill
perfidy - n. treachery or deceit
perfunctory - adj. done without much effort, care, or thought
peripheral - adj. on the edge or periphery; not centrally important
permeate - v. to pervade or penetrate throughout
perseverance - n. persistence in the face of obstacles
peruse - v. to read something carefully and closely
pervasive - adj. found everywhere, widespread; often has a negative connotation
phenomena - n. things that happen
phlegmatic - adj. cool and unruffled
pith - n. the essential substance of something
placate - v. to calm, esp. an angry or upset person
plastic - adj. easily shaped or molded
platitude - n. a trite or clich√© statement
plausible - adj. believable, reasonable
plethora - n. a surplus or overabundance of something
plummet - v. to fall quickly and far
polarize - v. to cause a sharp division between two groups
polemical - adj. angry, hostile, harshly critical
pragmatic - adj. practical
precarious - adj. uncertain or unstable
preceded - adj. went before
precipitate - v. to cause
precursor - n. a forerunner
prescient - adj. knowing things before they happen, prophetic
presumptuous - adj. overly familiar; invades social boundaries
prevail - v. to succeed, esp. with respect to vanquishing an opponent
prevaricate - v. to evade or deceive without outright lying
pristine - adj. untouched, clean, pure
probity - n. integrity and honor
prodigal - n. a reckless spender
prodigious - adj. enormous, immense, gigantic
profligate - adj. extravagant and wasteful, esp. in an immoral way
proliferate - v. to multiply and spread rapidly
propitiate - v. to obtain special favor from someone, esp. a powerful person or deity, by performing a pleasing action
propriety - n. appropriateness, manners, decorum
prospective - adj. potential or likely
qualification - n. credential
quotidian - adj. relating to the everyday or mundane
rationalize - v. to attempt to justify with reasons that are only superficially valid
reconcile - v. to bring into harmony
recondite - adj. arcane or obscure
refute - v. to rebut or disprove
relentless - adj. never stopping, constant
relevant - adj. relating to the topic or issue at hand
reproach - v. to scold or express criticism
repudiate - v. to renounce or disown
rescind - v. to take back or retract (an offer or statement)
respectively - adv. in the sequential order previously given
reticent - adj. hesitant to speak
reverent - adj. solemn and respectful
rhetoric - n. the art of effective communication (written or verbal)
salubrious - adj. health-promoting
sanction - v. to give official permission
satiate - v. to completely satisfy (with respect to hunger or appetite)
secular - adj. of or relating to the world or worldly matters (as opposed to religious ones)
sediment - n. material that settles at the bottom of a body of water
sedulous - adj. dedicated and careful
simultaneous - adj. occurring at the same moment
solicitous - adj. considerate, attentive
soporific - adj. makes sleepy
sparse - adj. scattered or scarce
specious - adj. spurious; appearing true but actually false
sporadic - adj. occasional or scattered
spurious - adj. fake or false
stolid - adj. calm and dependable
subjective - adj. open to personal interpretation; not based in objective fact
substantiate - v. to corroborate or give evidence of something
subversive - adj. meant to undercut established institutions or norms
sufficient - adj. enough for a given purpose
superbly - adv. excellently
supine - adj. laying back with the face upward (opposite position to prone)
supplant - v. to overtake or replace
sycophant - n. a fawning, insincere admirer
synthesize - v. to combine disparate parts into a coherent whole
tacit - adj. unspoken; implicit
taciturn - adj. reticent or reserved; tending towards silence
temperance - n. moderation and restraint, sometimes used to specifically describe abstinence from alcohol
tenuous - adj. weak, flimsy, insubstantial
timorous - adj. meek or timid
tirade - n. an angry rant
torpor - n. tiredness, lethargy
tortuous - adj. winding or twisty
tractable - adj. can be easily influenced or managed
transient - adj. passes quickly; short-lived
ubiquitous - adj. ever-present or universal
unadorned - adj. plain; unembellished
undermine - v. to weaken or compromise
underscore - v. to line underneath for emphasis
untenable - adj. weak or unsupportable, esp. with respect to an opinion or situation
vacillate - v. to shift between multiple options or opinions
venality - n. the state of being capable of being bribed
venerate - v. to give a high degree of respect; may border on worship
veracity - n. Truth and factual accuracy
verbose - adj. long-winded; loquacious
vexation - n. state of being frustrated, irritated, or concerned.
volatile - adj. easily changeable or extreme; unstable
whimsical - adj. fanciful or capricious
zeal - n. passion or fervor
